8 7
0 2
5 6
L-_|_-_-
|L--|_-_
|-_-|_L-
|L|L||L|
L__L-_L|
_-L|-L||
L__L__L_